11 5
0 W 0 D 0 W b 0 W W 0
W W 0 W 0 W 0 W 0 E 0
d W A W e 0 0 W 0 W 0
0 W 0 W W 0 0 W C W W
S 0 0 0 a W 0 B 0 0 c